11111111111111111
10000000000000001
10011111111111001
10000000000000001
10000000000010001
10000000000010001
10000000000010001
10000000000010001
11111000000010001
10001000000000001
10001000000000001
10001000000000001
10001000000000001
10000000111100001
10000000000000002
11111111111111111
