11111111111111111
10000000000000001
11111111111111001
12100000000000001
10100100000010001
10100100000010001
10100111000010001
10000000000010001
11111001110010001
10001000000000001
10001000100000001
10001011110000001
10001000000000001
10011000111100001
10000000000000001
11111111111111111
