33333333333333333
30000000000000003
33333333333333003
30300000000000003
30300300000030003
30300300000030003
30300333000030003
30000000000030003
33303003330030003
30003000000000003
33003000300000003
30003033330000003
30003000000000003
30033000333300003
32003000000000003
33333333333333333
